org-after-demote-entry-hook 	org-after-promote-entry-hook
org-after-refile-insert-hook 	org-after-sorting-entries-or-items-hook
org-after-tags-change-hook 	org-after-todo-state-change-hook
org-after-todo-statistics-hook 	org-agenda-after-show-hook
org-agenda-before-write-hook 	org-agenda-cleanup-fancy-diary-hook
org-agenda-entry-text-cleanup-hook 	org-agenda-mode-hook
org-babel-after-execute-hook 	org-babel-post-tangle-hook
org-babel-pre-tangle-hook 	org-babel-tangle-body-hook
org-blocker-hook 	org-checkbox-statistics-hook
org-clock-before-select-task-hook 	org-clock-cancel-hook
org-clock-goto-hook 	org-clock-in-hook
org-clock-in-prepare-hook 	org-clock-out-hook
org-ctrl-c-ctrl-c-final-hook 	org-ctrl-c-ctrl-c-hook
org-cycle-hook 	org-export-blocks-postblock-hook
org-export-define-heading-targets-headline-hook
org-export-first-hook 	org-export-html-after-blockquotes-hook
org-export-html-final-hook
org-export-preprocess-after-blockquote-hook
org-export-preprocess-after-headline-targets-hook
org-export-preprocess-after-include-files-hook
org-export-preprocess-after-radio-targets-hook
org-export-preprocess-after-tree-selection-hook
org-export-preprocess-before-backend-specifics-hook
org-export-preprocess-before-normalizing-links-hook
org-export-preprocess-before-selecting-backend-code-hook
org-export-preprocess-final-hook 	org-export-preprocess-hook
org-finalize-agenda-hook 	org-follow-link-hook
org-font-lock-hook 	org-font-lock-set-keywords-hook
org-insert-heading-hook 	org-load-hook
org-metadown-hook 	org-metaleft-hook
org-metareturn-hook 	org-metaright-hook
org-metaup-hook 	org-mode-hook
org-occur-hook 	org-pre-cycle-hook
org-read-date-minibuffer-setup-hook 	org-reveal-start-hook
org-shiftdown-final-hook 	org-shiftdown-hook
org-shiftleft-final-hook 	org-shiftleft-hook
org-shiftmetadown-hook 	org-shiftmetaleft-hook
org-shiftmetaright-hook 	org-shiftmetaup-hook
org-shiftright-final-hook 	org-shiftright-hook
org-shiftup-final-hook 	org-shiftup-hook
org-speed-command-hook 	org-src-mode-hook
org-tab-after-check-for-cycling-hook 	org-tab-after-check-for-table-hook
org-tab-before-tab-emulation-hook 	org-tab-first-hook
org-todo-get-default-hook 	org-todo-setup-filter-hook
org-todo-statistics-hook 	org-trigger-hook
orgtbl-after-send-table-hook
